#####B#
#     #
##  # #
## #  #
## ## #
   ## #
A     #
#######
